1111111111111
1C00000000C01
1110011110C11
1P0011E0C0001
1111111111111
