111111111111111111111111111111111111111111111
1000101010101000000000000001111000000000P0001
1E0000100000000000000100000000000000100000001
1000000000000000000000000CCCC1110000000000001
110000000000000000000000000000000000000000001
100000001110000001000001010100000000000000011
100000000000000100000000000000000001110000001
100000000000000000000000000000000000000000001
10000000000000000CC0000000000000C000000000001
111111111111111111111111111111111111111111111
